---------------------------------------------------------------------------------------------------------------------------------------------------------------------
---------------------------------------------------------------------------------------------------------------------------------------------------------------------
---------------------------------------------------------------------------------------------------------------------------------------------------------------------
-----------------------------------oooo--------------------------------ooooo-----------------------------------------------------------------------------------------
--------------------------XXX-----XXXXXXE-----------------------------XXXXXXX------------------XXX------XXXXXX---?------------------XXX------------------XXX---------
--------------------XXX-----------------------------------E------------------------XXX-----------------------------------------------------------XXXX----------------
------------------------------------------------------------------------------------------------------------------------------XXX------------------------------------
----------------o------------------------------------------------------------------o-o----------------------------------o-oo-----------------------------------------
---------------XXX--------XXX-----------------------------------XXX----------------o-o-XXX----------XX-------XXXEX-----XXXEXX----------------------------------------
------------------------------------------------------------XX-----------------------------------------------------------------------------XXX-----------------------
---------------------------------------------------------------------------------------------------------------------------------------------------------------------
-----------------------------------------XXXXEXXEX----XXX-----------------------------------------------------------------------------------------------------------X
XXXXXXXXXXX--------------------------------------------------------------------------------XXEXXXX------------------------------------------------------------XXXXXXX
XXXXXXXXXXX---------------------------------------------------------------------------------------------------------------------------------------------------XXXXXXX
